
 .S #  .  #  .  #  #  .  .  . 
 .  .  .  #  .  .  .  #  .  . 
 .  1  .  #  #  #  #  #  .  # 
 .  .  .  #  .  .  #  .  .  . 
 #  .  .  .  .  #  .  .  #  # 
 .  .  #  #  .  .  .  .  .  . 
 .  .  .  .  #  .  #  .  .  . 
 .  #  .  .  .  .  .  .  .  . 
 #  .  #  #  .  .  .  .  1  . 
 .  .  .  .  #  .  .  #  . .E